11111111111
1P0000000E1
10110001101
1010C0D0101
10000100001
10D01110001
10000100001
10100D00101
1C110001101
100000C0001
11111111111
