111111111
100000C01
10P000001
10C000E01
100000P01
111111111
